-7
15
0
7
00000000000000000000000
00000000000001111111000
00000000000001111111000
00000000000001111111010
00000000000001111111000
00000000000001111111000
00000000000001111111000
10010000000001111111010
