-20
22
-7
8
0000000000000000000000000000000000000000000
1111111111111111111111111111111111111111110
0000000000000000000000000011111110000000000
0000000000000000000000000011111110000000000
0000000000000000000000000011111110100000000
0001000111000100011100010011111111000000000
0001000111100100011110010011111111000000000
0000000000000000000000000011111110000000000
0000000000000100100000000011111110100000000
0000000000000000000000000000000000000000000
0000000000000000000000000000000000000000000
0000000000000000000000000000000000000000000
0001000111000100011100010001110001000000000
0001000111100100011110010001111001000000000
0000000000000000000000000000000000000000000
0000000000000000000000000000000000000000000
