-20
22
-7
8
0000000000000000000000000000000000000000000
0000000000000000000000000000000000000000000
0000000000000000000000000011111110000000000
0000000000000000000000000011111110000000000
0000000000000000000000000011111110100000000
0000000000000000000000000011111110000000000
0000000000000000000000000011111110000000000
0000000000000000000000000011111110000000000
0000000000000100100000000011111110100000000
0000000000000000000000000000000000000000000
0000000000000000000000000000000000000000000
0000000000000000000000000000000000000000000
0000000000000000000000000000000000000000000
0000000000000000000000000000000000000000000
0000000000000000000000000000000000000000000
0000000000000000000000000000000000000000000
